,Peak_1,Peak_2,Peak_1_idx,Peak_2_idx,Peak_dist
0,32767,32767,16278,26016,9738
1,32767,32767,17341,29507,12166
2,32767,32767,15455,30247,14792
3,32767,32767,7392,17930,10538
4,29403,29080,179,28424,28245
5,29125,27785,14674,23830,9156
6,32767,31129,9086,17849,8763
7,25438,32767,5732,16867,11135
8,31638,32767,11724,24586,12862
9,28943,32767,21934,35041,13107
10,32767,28909,5380,38456,33076
11,26880,32767,24,11747,11723
12,26286,25146,1308,20661,19353
13,19770,24375,448,20623,20175
